##############################
#                            #
# ########                   #
#        #       ##          #
#        ##      ##          #
#                            #
#        ###   ####          #
#        ###      #          #
#              ####          #
#                            #
#                            #
#                            #
#                            #
#                            #
#                            #
#                            #
#                            #
#                            #
##############################